#################################################################
#                       #                    #      #           #
#  ##### ##      ##          #########       #      #           #
## # ###  #  # #      #### ###############   #      #        #  #
#  # ####    #    #            ######      ###                #  #
##    ##  #    #####    ################  ####                 #  #
####      # #     #  #     ###               ###################  #######
#     ##### #      #    #                                               #
#            #              #   ##########   ###########   ##############
#            ##########           ######     #        #   #
#  ### # ##       #        ##       #        #       #   #
## #   #  #  #    #    #     #               #      #   #
#  # ####    #        ####  ##########       #     #   #
##    ##  #    #####  #              #       #     #   #
####      # #     #   #              #       #######   #######
#     ##### #      #  # # # ##########                       #
#  A         #        #                            #          #
###############################################     #         #
                 #              #            #       #        #
            #    ###    #        #          #    #            #
            #    #      #             #         #              #
            #           #           #          #               #
 ########################################   ####################
                               B      #   #   #      ############
                    ########          #   #    #             #####
          ############################   #     #   ##        #####
#######                                            #            ##
#############                        #                  ##########
####################                ###          #################
#############################                #####################
##################################################################
