#######################
#                     #
#  ##### ##       B   #
## # ###  #  #        #
#  # ####    #        #
##    ##  #    #####  #
####      # #     #   #
#     ##### #      #  #
#            #        #
#            ##########
#  ##### ##           #
## # ###  #  #        #
#  # ####    #        #
##    ##  #    #####  #
####      # #     #   #
#     ##### #      #  #
#  A         #        #
#######################
